      #  #
  #    ###
  #    #  
  #   #  #
     # ## 
      #   
# #    # #
# # #  # #
#       ##
   # ### #