WWWWWWWWWWWWWWWWWWWW 
W                  W
W         WWWWWW   W
W    WWWW      W   W
W    W        WWWW W
W  WWW  WWWW       W
W  W W     W       W
W  W       W  WWW WW
W  WWW WWW W W     W
W    W  W    W W   W
WWW  W  WWWWW  W   W
W W    WW          W
W W WWWW    WWW    W
W   W    E    W    W
WWWWWWWWWWWWWWWWWWWW